################
#......        #
#..######      #
#......  ####  #
#..####        #
#......        #
################
